NO textures/simple_tiles.xpm
SO textures/simple_tiles.xpm
WE textures/simple_tiles.xpm
EA textures/simple_tiles.xpm

F 0,0,1
C 225,30,0





1111111111111111111111111111             111111111111
1000000000110000000000001               11111111011111
1011000001110000000000001                    111111
10010000000000000000000011111111
111111111011000001110000000000001
1000000000110000011101111111111111111111111111111111111111111111111111111
1111011111111101110W000010001
11110111111111011101010010001
110000001101010111000000100011111111111111111111111111111111111111111111111111
10000000000000001100000010001
10000000000000001101010010001
111111111111111111111111111111
11000001110101011111011110N0111          
11110111 1110101 101111010001
11111111 1111111 111111111111                
1    1
1    1   1    11    111     
1        
1
1
1
1
1
1       
                                           


